1111111111111111111111111111111111111111111111111
1000000000000000000000000000000000000000000000001
1000000000000000000000000000000000000000000000001
1000000000000000000000000000000000000000000000001
1000000000000000000000000000000000000000000000001
1000000000000000000000000000000000000000000000001
1000000000000000000000000000000000000000000000001
1000000000000200320000000000300000000000000000001
1000000000000122210000003222200000000000222000001
1000000000000000000000222100000222222222110000001
1000000000000000000000000000000000000000110000001
1000000000002003200000000000000000000000110000221
1000000000001222100000000000000000000000110000001
1000000000000000000000000000000000000000110000001
1000000000000000000000000000000000000000112200001
1000030000000000000000000000000000000000110000001
1000220000000000000000000000000000000000110000001
1000000000000000000000000000000000000000110000221
1000000000000000000000000000000022222220110000001
1000000000000000000000000000000011111110112200001
0000000000000000000000000000000011111110110000001
1220000000020000000000000000222211111110110000001
1110000000012222222222222222111111111110110000000
1110000000011111111111111111111111111110112222221
1110000000011111111111111111111111111110111111111
1110000000011111111111111111111111111110111111111
1110000000011111111111111111111111111110111111111
1111111111111111111111111111111111111110111111111
1111111111111111111111111111111111111110111111111
1111111111111111111111111111111111111110111111111
1111111111111111111111111111111111111110111111111
1111111111111111111111111111111111111110111111111
1000000000000000000000000000000000000000000000001
1000000000000000000000000000000000000000000000001
1000000000000000000000000000000000000000000000001
1000000000000000000000000000000000000000000000001
1000000000000000000000000000000000000000000000001
1000000000000000000000000000000000000000000000001
1000000000000000000000000000000000000000000000001
1000000000000000000000000000000000000000000000001
1000000000000000000000000000000000000000000000001
1000000000000000000000000000000000000000000000001
1111111111111111111111111111111111111111111111111

