1000000000000000000000000000000000000000000000001
1000000000000000000000000000000000000000000222221
1000000000000000000000000000000000000000000000001
1000000000000000000000000000000000000000000000001
1222000000000000000000000000000000000000000000001
1000000000000000000000022200000000000000000000001
1000200000000000222200000000000000000000000000001
1000100000200000000000000000000000000000000000001
1000000000100000000000000000000000000000000000001
1000000000100000000000000000000000000000000000001
1000000000100000000000000000000000000000000000001
1222222222222222222222222222222222222222222222221
1111111111111111111111111111111111111111111111111
