000000000000000000000000000000202
000000000000000000000000000000101
000000000000000000000000000000101
000000000000000000000000000000101
000000022222000000000000000000101
000000000000000000000000000000101
220000000000000002200000022000101
112222222222222221100002211200101
111111111111111111100001111100101
111111111111111111100000110000101
111111111111111111100000100000101
111111111111111111100000100000101
111111111111111111111111111100001
000000000000000000000000000011111
